####################
#******************#
#******************#
###**#*************#
#****#*************#
#****#*************#
#**###**##*********#
#**#*****#*********#
#**#######*********#
#********#**########
#**#**#**#**#******#
####**####**#####**#
#********#*********#
######***#####**#**#
#************#**#**#
#****######**#**####
#*********#**#*****#
########**#**####**#
#*********#********#
#******************#
#******************#
#******************#
###**#*************#
#****#*************#
#****#*************#
#**###**##*********#
#**#*****#*********#
#**#######*********#
#********#**########
#**#**#**#**#******#
####**####**#####**#
#********#*********#
######***#####**#**#
#************#**#**#
#****######**#**####
#*********#**#*****#
########**#**####**#
#*********#********#
#******************#
#******************#
####################